SBILIFE - SBILIFEEQN
TECHM - TECHMEQN
TCS - TCSEQN
INFY - INFYEQN
ULTRACEMCO - ULTRACEMCOEQN
HINDUNILVR - HINDUNILVREQN
GRASIM - GRASIMEQN
INDUSINDBK - INDUSINDBKEQN
ICICIBANK - ICICIBANKEQN
RELIANCE - RELIANCEEQN
HDFCBANK - HDFCBANKEQN
ITC - ITCEQN
HCLTECH - HCLTECHEQN
TITAN - TITANEQN
HDFCLIFE - HDFCLIFEEQN
WIPRO - WIPROEQN
NESTLEIND - NESTLEINDEQN
LT - LTEQN
TATACONSUM - TATACONSUMEQN
KOTAKBANK - KOTAKBANKEQN
SUNPHARMA - SUNPHARMAEQN
M&M - M&MEQN
HINDALCO - HINDALCOEQN
ONGC - ONGCEQN
ASIANPAINT - ASIANPAINTEQN
EICHERMOT - EICHERMOTEQN
BHARTIARTL - BHARTIARTLEQN
CIPLA - CIPLAEQN
COALINDIA - COALINDIAEQN
SBIN - SBINEQN
HEROMOTOCO - HEROMOTOCOEQN
MARUTI - MARUTIEQN
TATASTEEL - TATASTEELEQN
TATAMOTORS - TATAMOTORSEQN
NTPC - NTPCEQN
JSWSTEEL - JSWSTEELEQN
BAJAJ-AUTO - BAJAJ-AUTOEQN
BAJFINANCE - BAJFINANCEEQN
DRREDDY - DRREDDYEQN
JIOFIN - JIOFINEQN
BEL - BELEQN
BAJAJFINSV - BAJAJFINSVEQN
POWERGRID - POWERGRIDEQN
APOLLOHOSP - APOLLOHOSPEQN
AXISBANK - AXISBANKEQN
ETERNAL - ETERNALEQN
TRENT - TRENTEQN
ADANIPORTS - ADANIPORTSEQN
ADANIENT - ADANIENTEQN
SHRIRAMFIN - SHRIRAMFINEQN
